MAP_ID 0
PORTALS 
NPCS 

GRID
           . .      ..#-#%%.........%%%%#=*  ..           .  .  
.      .           .    #####=+0+=######      .            .  ..
 .   .               .               .             .           .
 .                                        .           .        .
            .                        .                        . 
              .  .            . .                  .       .   .
   .   .                         .              .    .         %
         . . .     .      .                                   ##
 .              .       .                                .   -#%
.  .  .        . .        .       .            .             :+%
###                     .    =.   #       .  .    .           #%
...#     .  .                +#===#:               . .        #%
######                  .   .=#  .#::     .                  ##%
.....-###            #########*   #:#: .      ..         .  ||#.
######=+O @     .      .   .   $$$ . ||   .                 +...
......###          .  %#%#.    $$$  ||:          .          0...
%+###*                   %#%##:   .####+  .      .          +...
...#         . .   .         #: .%.                         ||..
..# .               .        #===#-               ..         ##%
###      .      . .    .     #   #-                    .      #%
       .  ...   .            #  .#-        .      .         . ##
  .       .  .         ..           .     .          .  .      #
    .                                           .        .      
                    . ..                   .        .        .  
.     .         . .    .   . .  .      .                        
    .  ..   .        .  .   .                   .               
 . .   .   .     .   .                  .                   .   
           .                              .  .                  
   .       .                      .                         .   
   .    .                .#=-+0+-=## .    .                     
.    .  .          . ######%......%%######  .     .             
    .. .       ####%%%%%%..............%%###       .      .     
