1,1
################################################################
#                                                              #
#                                                              #
#      ##########                                              #
#      #        #                                              #
#      #        #                      ###################     #
#      #        #                      #                 #     #
#      ##########                      #                 #     #
#                                      #                 #     #
#                                      #                 #     #
#                                      #                 #     #
#                                      ###################     #
#                                                              #
#                                                              #
#                                                              #
#                                                              #
#                                                              #
#    ##################                                        #
#    #                #                                        #
#    #                #                                        #
#    #                #                 #######                #
#    #                #                 #     #                #
#    ##################                 #     #                #
#                                       #     #                #
#                                       #######                #
#                                                              #
#                                                              #
#                                                              #
#                                                              #
#                                                              #
#                                                              #
################################################################