0,0
                 -@#:                                           
                 @@@@*                                          
               :+@@@@%.                                         
               *@@@*+*.                    =@@@@*               
               *@*:::=#:             :-=***#%%%%@@@=            
               *@::::=#: :******: :**:....:+%%%%@%:             
               -**:::===:.   ...:-::.::.::*%%@@%=               
                 *=-:... .... .........:=#%%%          .=+=:    
                  #=.....:..::-*#=::::=+=             =-:.:-=:  
                 %*#+::.....:=%*%@#:.:+%            ::.....:=-. 
                 %@%*::+=:.:::*@@*-:.:=*         ::::..::....== 
               :==*+-.:==-:....::=*%%*=+%:    :--::..:.::.::.:=-
               +%%:::-*#=-:**=:::*%%%%*=@:   *::...........:..-*
               +%%:::::::::::::::=*%%*==@: .-=::::::....:....=*-
                 *:::::::::::::::::::::=@:==::::::::::....=@@=  
                  @*:::::::::::::::::::-=*==*::::::::-#**+-     
                  @+.::::::::::::::::::.:%-  #=-::-#@%          
                  @+.::.:::::::--:::::..:%-   =+=-==:           
                 :-:.:=:......:-:.......:==: -%*-::+=:          
                 @::.::=-:.:::=::..:::::.:%@**==-:-+%%          
                 @+-..:=-:.:-=-::..:=-:.::%@#==+*==.            
                 @#=..::==::*%::..-+::.:::-%@@**%*.             
               =#:::=+*=::..::=+*=::.::::::*@#%%#%@=            
              *+:...::::......::::..:::::::*%@#%@%:             
              #*:::::::.::::..::::::::::::::-@=:                
               =*::::::::::::::::::::::::::*%                   
               :=%%=:::--+%%%%%*=::::::::-**-                   
               =*%-=*%%%%*      +#*++-:-+#:                     
                                                                
                                                                
                                                                
                                                                